S . # . . E
. . # . . .
. . # . . .
. . # . . .
. . # . . .
. . . . . .