S . # # . . .
. . # . # # E
# . # . . . #
# . . . # . #
# # # . # . .
. . . . # . .