E . . . . . # # # # # # # # # # # # # # # # # # # # # # # # # # # # # # # # # # # # # # # # # # #
# # # # # . # . . . . . . . . . . # . . . . . . . . . . . # . . . . . . . . . . . # . . . . . . .
. . . . # . # . # # # # # # # # . # . # # # # # # # # # . # . # # # # # # # # # # . # . # # # # #
. # # . # . # . # . . . . . . # . # . # . . . . . . # . # . # . . . . . . . . . # . # . . . . . .
. # # . # . # . # . # # # # . # . # . # . # # # # . # . # . # . # # # # # # # . # . # . # # # # .
. # # . # . # . # . # . . # . # . # . # . # . . # . # . # . # . # . . . . . # . # . # . # . . # .
. # # . # . # . # . # . . # . # . # . # . # . . # . # . # . # . # . # # # . # . # . # . # . . # .
. # # . # . # . # . # . . # . # . # . # . # . # # . # . # . # . # . # . . # . # . # . # . # # # .
. # # . # . # . # . # . . # . # . # . # . # . # . . . . # . # . # . # . . # . # . # . # . . . . .
. # # . # . # . # . # . . # . # . # . # . # . # . # # # # # # . # . # . . # . # . # . # . # # # .
. # # . # . # . # . # . . # . # . # . # . # . # . . . . . . . # . # . . # . # . # . # . # . . # .
. # # . # . # . # . # . . # . # . # . # . # . # . # # # # # # # . # . . # . # . # . # . # . . # .
. # # . # . # . # . # . . # . # . # . # . # . # . . . . . . . # . # . . # . # . # . # . # . . # .
. # # . # . # . # . # . . # . # . # . # . # . # . # # # # # # # . # . . # . # . # . # . # . . # .
. # # . # . # . # . # . . # . # . # . # . # . # . . . . . . . # . # . . # . # . # . # . # . . # .
. # # . # . # . # . # . . # . # . # . # . # . # . # # # # # # # . # . . # . # . # . # . # . . # .
. # # . # . # . # . # . . # . # . # . # . # . # . . . . . . . # . # . . # . # . # . # . # . . # .
. # # . # . # . # . # . . # . # . # . # . # . # . # # # # # # # . # . . # . # . # . # . # . . # .
. # # . # . # . # . # . . # . # . # . # . # . # . . . . . . . # . # . . # . # . # . # . # . . # .
. # # . # . # . # . # . . # . # . # . # . # . # . # # # # # # # . # . . # . # . # . # . # . . # .
. # # . # . # . # . # . . # . # . # . # . # . # . . . . . . . # . # . . # . # . # . # . # . . # .
. # # . # . # . # . # . . # . # . # . # . # . # . # # # # # # # . # . . # . # . # . # . # . . # .
. # # . # . # . # . # . . # . # . # . # . # . # . . . . . . . # . # . . # . # . # . # . # . . # .
. # # . # . # . # . # . . # . # . # . # . # . # . # # # # # # # . # . . # . # . # . # . # . . # .
. # # . # . # . # . # . . # . # . # . # . # . # . . . . . . . # . # . . # . # . # . # . # . . # .
. # # . # . # . # . # . . # . # . # . # . # . # . # # # # # # # . # . . # . # . # . # . # . . # .
. # # . # . # . # . # . . # . # . # . # . # . # . . . . . . . # . # . . # . # . # . # . # . . # .
. # # . # . # . # . # . . # . # . # . # . # . # . # # # # # # # . # . . # . # . # . # . # . . # .
. # # . # . # . # . # . . # . # . # . # . # . # . . . . . . . # . # . . # . # . # . # . # . . # .
. # # . # . # . # . # . . # . # . # . # . # . # . # # # # # # # . # . . # . # . # . # . # . . # .
. # # . # . # . # . # . . # . # . # . # . # . # . . . . . . . # . # . . # . # . # . # . # . . # .
. # # . # . . . # . # . . # . # . # . # . # . # . # # # # # # # . # . . # . # . # . # . # . . # .
. # # . # . # . # . # . . # . # . # . # . # . # . . . . . . . # . # . . # . # . # . # . # . . # .
. # # . # . # . # . # . . # . # . # . # . # . # . # # # # # # # . # . . # . # . # . # . # . . # .
. # # . # . # . # . # . . # . # . # . # . # . # . . . . . . . # . # . . # . # . # . # . # . . # .
. # # . # . # . # . # . . # . # . # . # . # . # . # # # # # # # S # . . # . # . # . # . # . . # .
. # # . # . # . # . # . . # . # . # . # . # . # . . . . . . . # . # . . # . # . # . # . # . . # .
. # # . # . # . # . # . . # . # . # . # . # . # . # # # # # # # . # . . # . # . # . # . # . . # .
. # # . # . # . # . # . . # . # . # . # . # . # . . . . . . . # . # . . # . # . # . # . # . . # .
. # # . # . # . # . # . . # . # . # . # . # . # . # # # # # # # . # . . # . # . # . # . # . . # .
. # # . # . # . # . # . . # . # . # . # . # . # . . . . . . . # . # . . # . # . # . # . # . . # .
. # # . # . # . # . # . . # . # . # . # . # . # . # # # # # # # . # . . # . # . # . # . # . . # .
. # # . # . # . # . # . . # . # . # . # . # . # . . . . . . . # . # . . # . # . # . # . # . . # .
. # # . # . # . # . # . . # . # . # . # . # . # . # # # # # # # . # . . # . # . # . # . # . . # .
. # # . # . # . # . # . . # . # . # . # . # . # . . . . . . . # . # . . # . # . # . # . # . . # .