. . . . . . . . . . .
. . . . . . . . . . .
. . . . . # . . . . .
. . . . . # . . . . .
. . . . . # . . . . .
S . . . . # . . . . E
. . . . . # . . . . .
. . . . . # . . . . .
. . . . . # . . . . .
. . . . . . . . . . .